########################################
# #                ##                # #
# # ############ # ## # ############ # #
# # #            # ## #            # # #
#     # ###### #        # ###### #     #
# # # #        # # ## #          # # # #
#     ##### ####   ##   #### #####     #
# # #            # ## #            # # #
# # # ############    ############ # # #
# # # #                          # # # #
# # # # ######## ###### ######## # # # #
#                                      #
# ####### ### ########### ### ######## #
# #                ##                # #
# ####### ######## ## ####### ######## #
#                # ## #                #
# # ############ # ## # ############ # #
# #          #             #           #
# # ########## ##### #### ########## # #
# # #          #   .    #          # # #
#   #          #   #    #          #   #
# # ########## ########## ########## # #
# #          #             #           #
# # ############ # ## # ############ # #
#                # ## #                #
# ####### ######## ## ####### ######## #
# #                ##                # #
# ####### ### ########### ### ######## #
#                                      #
# # # # ######## ###### ######## # # # #
# # # #                          # # # #
# # # ############    ############ # # #
# # #            # ## #            # # #
#     ##### ####   ##   #### #####     #
# # # #        # # ## #          # # # #
#     # ###### #        # ###### #     #
# # #            # ## #            # # #
# # ############ # ## # ############ # #
# #                ##                # #
########################################
